[coherence.plugins.backend.media_renderer]
BuzztardPlayer=coherence.backends.buzztard_control:BuzztardPlayer
ElisaPlayer=coherence.backends.elisa_renderer:ElisaPlayer
GStreamerPlayer=coherence.backends.gstreamer_renderer:GStreamerPlayer

[coherence.plugins.backend.media_server]
AmpacheStore=coherence.backends.ampache_storage:AmpacheStore
AppleTrailersStore=coherence.backends.appletrailers_storage:AppleTrailersStore
AudioCDStore=coherence.backends.audiocd_storage:AudioCDStore
AxisCamStore=coherence.backends.axiscam_storage:AxisCamStore
BansheeStore=coherence.backends.banshee_storage:BansheeStore
BuzztardStore=coherence.backends.buzztard_control:BuzztardStore
DVBDStore=coherence.backends.dvbd_storage:DVBDStore
ElisaMediaStore=coherence.backends.elisa_storage:ElisaMediaStore
FSStore=coherence.backends.fs_storage:FSStore
FeedStore=coherence.backends.feed_storage:FeedStore
FlickrStore=coherence.backends.flickr_storage:FlickrStore
Gallery2Store=coherence.backends.gallery2_storage:Gallery2Store
IRadioStore=coherence.backends.iradio_storage:IRadioStore
ITVStore=coherence.backends.itv_storage:ITVStore
LastFMStore=coherence.backends.lastfm_storage:LastFMStore
LolcatsStore=coherence.backends.lolcats_storage:LolcatsStore
MediaStore=coherence.backends.mediadb_storage:MediaStore
MiroGuideStore=coherence.backends.miroguide_storage:MiroGuideStore
PicasaStore=coherence.backends.picasa_storage:PicasaStore
PlaylistStore=coherence.backends.playlist_storage:PlaylistStore
RadiotimeStore=coherence.backends.radiotime_storage:RadiotimeStore
SWR3Store=coherence.backends.swr3_storage:SWR3Store
TEDStore=coherence.backends.ted_storage:TEDStore
TestStore=coherence.backends.test_storage:TestStore
TrackerStore=coherence.backends.tracker_storage:TrackerStore
TwitchStore=coherence.backends.twitch_storage:TwitchStore
YamjStore=coherence.backends.yamj_storage:YamjStore
YouTubeStore=coherence.backends.youtube_storage:YouTubeStore

[console_scripts]
cohen3=coherence.cli:main

